NO ./textures/north.xpm
SO ./textures/south.xpm
WE ./textures/west.xpm
EA ./textures/east.xpm

F 21,27,36
C 9,42,89

1111111111111111
1000000000000001
1000000000000001
1000011D1100D001
1000010000100001
1000010000100001
100001N000100001
1000010000100001
1000011111100001
1000000000000001
1000000000000001
1111111111111111
