NO ./textures/north.xpm
SO ./textures/south.xpm
WE ./textures/west.xpm
EA ./textures/east.xpm

F 69,72,71
C 9,42,89

111111111111111111111111111111
100000000000000000000000000001
100000000000000000000000000001
100000000000000111111111000001
100000000000000100000001000001
100100000000000101110011000001
100000010100000101010010000001
100000010100000101011100000001
100000010111111101000000000001
100000010000000001000000000001
1000001111111111110000000000011111111
1000000000000000000W10000000000000001
1010000000000000000000000000000000001
1000000000000000000000000000011111111
111111111111111111111111111111